Custom Stomach Storage|自定义胃部储存

CustomStomachStorage.Redlyn-name|自定义胃部储存
CustomStomachStorage.Redlyn-description|自定义蛞蝓猫的胃部储存物品的类型和数量。<LINE><LINE>源代码：https://github.com/SYFL-code/CustomStomachStorage

Customize the type and quantity of items stored in the Slugcat's stomach.<LINE><LINE>Source code: https://github.com/SYFL-code/CustomStomachStorage|自定义蛞蝓猫的胃部储存物品的类型和数量。<LINE><LINE>源代码：https://github.com/SYFL-code/CustomStomachStorage

Options|选项
Type|类型

Custom Stomach Storage|自定义胃储存容量
Types of swallowing|吞咽类型
Types of graspable|抓取类型

Stomach capacity|胃部容量
Allow Spearmaster to store items|允许矛大师存储物品
DebugMode|调试模式

All|全部

One hand can grab all|一只手能抓住全部
At least able to drag all|至少能拖动全部

Item|物品
Spear|矛
VultureMask|秃鹫面具
NeedleEgg|面条蝇卵
JokeRifle|玩笑步枪
EnergyCell|质量稀释电池
MoonCloak|斗篷
Boomerang|回旋镖

Creature|生物
Lizard|蜥蜴
Vulture|秃鹫
Centipede|蜈蚣
Spider|蜘蛛
DropBug|落网虫
BigEel|利维坦
MirosBird|钢鸟
DaddyLongLegs|腐化物
Cicada|蝉乌贼
Snail|波动龟
Scavenger|拾荒者
EggBug|蛋虫
LanternMouse|光鼠
JetFish|蛙鱼
TubeWorm|管虫
Deer|雨鹿

Yeek|跃客
Inspector|监察者
StowawayBug|偷渡者

Loach|泥鳅
BigMoth|大蛾
SkyWhale|天空鲸
BoxWorm|箱虫
DrillCrab|钻蟹
Tardigrade|水熊虫
Barnacle|藤壶
Frog|青蛙